ALL	AO L
BACKWARD	B AE K W ER D
BALL?	B AO L
CAN	K AE N
CAN(2)	K AH N
CHARGER?	CH AA R JH ER
CUB	K AH B
DANCE	D AE N S
DANCING	D AE N S IH NG
FORWARD	F AO R W ER D
HELLO	HH AH L OW
HELLO(2)	HH EH L OW
IS	IH Z
IT?	IH T
LEFT	L EH F T
ME?	M IY
MOVE	M UW V
MOVING	M UW V IH NG
MY	M AY
PLAY	P L EY
PLAYING	P L EY IH NG
RIGHT	R AY T
SEE	S IY
SOMETHING	S AH M TH IH NG
STOP	S T AA P
THE	DH AH
THE(2)	DH IY
TIME	T AY M
WHAT	W AH T
WHAT(2)	HH W AH T
WHERE	W EH R
WHERE(2)	HH W EH R
YOU	Y UW
